###.##e.....
##########.#
...........#
.#.#########
.#....######
#####.######
.........###
####.#######
####.#######
##......s...
####.###.###
.....###.###


