###.##e.....
##########.#
#..........#
##.#########
##....######
#####.######
.........###
####.#######
####.#######
##......s...
####.###.###
.....###.###


