###.##e.....
##########.#
...........#
.#.#########
.#....#....#
#####.####.#
...........#
####.#####.#
#.##.#######
#.......s...
####.###.###
.....###.###


